ano,local,ouro,prata,bronze,total,ranking
1948,Londres,0,0,1,1,34
1952,Helsinque,1,0,2,3,24
1956,Melbourne,1,0,0,1,24
1960,Roma,0,0,2,2,39
1964,Tóquio,0,0,1,1,35
1968,Cidade do México,0,1,2,3,35
1972,Munique,0,0,2,2,41
1976,Montreal,0,0,2,2,36
1980,Moscou,2,0,2,4,17
1984,Los Angeles,1,5,2,8,19
1988,Seul,1,2,3,6,24
1992,Barcelona,2,1,0,3,25
1996,Atlanta,3,3,9,15,25
2000,Sydney,0,6,6,12,52
2004,Atenas,5,2,3,10,16
2008,Pequim,3,4,10,17,22
2012,Londres,3,5,9,17,22
2016,Rio de Janeiro,7,6,6,19,13
